SO ./textures/32x32_test.png
NO ./textures/32x32_test.png
WE ./textures/stone_bricks.png
EA ./textures/scream.png
E ./lulec
EAEAEAA ./kamardde
F 220,100,0
C 225,30,0
naprosta                        hovadina





111111111111
111111111111
110000000001
11N000000001
110000000001
110000000001
110000000001
110001000001
110000000001
110000000001
110000000001
111111111111
111111111111