               NO      ./path_to_the_north_texture
SO   ./path_to_the_south_texture
WE                      ./path_to_the_west_texture      sad
EA ./path_to_the_east_texture
E ./lulec
EAEAEAA ./kamardde
F 220,100,0
C 225,30,0
naprosta                        hovadina



        1111 11111 11111111       111  111
        11N0000111100000111111111 101  101
        100000000011000000010000111111 111
        1011000001110000001 1000111111
        1001000000000000000100001
111111111011000001110000000010001
10000000001100000111011111111111
11110111111111011100000010001
11110111111111011101010010001
1100000011010101110000001000111111
10000000000000001100000010001000001
1000000000000000110101001000111011       
11000001110101011111011110001 1111
11110111 1110101 101111010001
11111111 1111111 111111111111