               N     ./textures/orange_b
			   NO      ./textures/orange_bricks.png
SO   ./textures/stone_bricks.png
WE                      ./textures/game_bricks.png
EA ./textures/old_bricks.png
E ./lulec
EAEAEAA ./kamardde  
F 1,1,1
C      180,200,200
naprosta                        hovadina


        11111111 1 11111111       111  111
        1100000111100000111111111 101  101
        1000000S0001100000001000111111 111
        10011000001110000001 1000111111
        10001000000000000000100001
        10001000000000000000100001
1111111100010000011100000000100011
100000000011000000000000000000001
100000000011000000000000000000001
100000000011000001110011111111111
1110001111111100111000000010001
11100011111111001110010010100001
110000001101010011100000001000111111
100000000000000011000000000001000001
100000000000000011000000000000000001
1000000000000000110010010010000111011       
11000001110101011111100111100001 1111
11110111 1110101 10111101000111
11111111 1111111 111 11111111