SO ./textures/32x32_test.png
NO ./textures/32x32_test.png
WE ./textures/stone_bricks.png
EA ./textures/scream.png
E ./lulec
EAEAEAA ./kamardde
F 220,100,0
C 225,30,0
naprosta                        hovadina





1111111111111
1111111111111
1111111111111
1110000000001
111N000000001
1110000000001
1110000000001
1110000000001
1110001000001
1110000000001
1110000000001
1110000000001
1111111111111
1111111111111