               NO      ./textures/svarbova_1.png
SO   ./textures/svarbova_3.png
WE                      ./textures/svarbova_4.png
EA ./textures/svarbova_derivation_I.png
E ./lulec
EAEAEAA ./kamardde  
F 206,186,156
C      238,226,218
naprosta                        hovadina


1111111111111111111111
100000S000000000000001
1000000000000000000001
1000000000000011111111
1000100000000000000001
1000100000000000000001
1000100000000000000001
1000100000000011111111
1000100000000000000001
1000100000000000000001
1111111111111111111111