               NO      ./path_to_the_north_texture
SO   ./path_to_the_south_texture
WE                      ./path_to_the_west_texture      sad
EA ./path_to_the_east_texture
E ./lulec
EAEAEAA ./kamardde
F 220,100,0
C 225,30,0
naprosta                        hovadina



        1111  11   11111111       111  111
        1100000111100000111111111 101  101
        100000000011000000010000111111 111
        1011000001110000001 10001111111
        1001000000000000000100001
111111111011000001110000000000001
100000000011000001110111111111111
11110111111111011100000010001
11110111111111011101010010001
11000000110101011100000010001
10000000000N00001100000010001
10000000000000001101010010001
11000001110101011111011110001
11110111 1110101 101111010001
11111111 1111111 111111111111