               NO      ./textures/32x32_test.png
SO   ./textures/32x32_test.png
WE                      ./textures/32x32_test.png      sad
EA ./textures/32x32_test.png
E ./lulec
EAEAEAA ./kamardde
F 220,100,0
C 225,30,0
naprosta                        hovadina





11111111111
1XXXXXXXXX1
1N000000001
10000C00001
10000000001
10000000001
100D0000001
1000H000001
10000000001
10000000001
11111111111