
NO ./textures/orange_bricks.png
SO ./textures/stone_bricks.png
WE ./textures/game_bricks.png
EA ./textures/old_bricks.png

F 220,100,0
C 225,30,0




11111111111
1111111N111
11111111111
11111111111
11111111111
11111111111