NO ./textures/nwall1.png
SO ./textures/swall1.png
WE ./textures/wwall1.png
EA ./textures/ewall1.png

F 127,127,127
C 255,255,255
B 0,0,0

  111111111111111111111111111111111111111111111111111111111  
  100000000010001000001000001000000000000000000010000000001  
  111000000011101000101000001111100000001010111110101111101  
  101000000010000000101000001010000000000010001000100000001  
  101111101110111000111000001010111111111111101011111011111  
  101000100010000000101000000000000000000000101000000000001  
  101000111010111000101010101111111111101010101011111110001  
  100000001000000000000010001000000010001010001010000000001  
  100000001011101011100010101000000010111110101010000010111  
  100000000000101010000010101000000010100000100000000010001  
  100000000000111010111110101000000010100000101110111110101  
  100000000000000000000000000000000010100000100000000010101    
  100000000000000000000000000000000010100000100000000010101    
  100000000000000000000000000000000010100000100000000010101    
  100000000000000000000000000000000000000000000000000000001    
  100000000000000000000000000000000000000000000000000000001    
  100000000000000000000000000000000000000000000000000000001    
  100000000000000000000000000000000000000000000000000000001    
  100000000000000000000000000000000000000000000000000000001    
  100000000000000000000000000000000000000000000000000000001    
  100000000000000000000000000000000000000000000000000000001    
  100000000000000000000000000000000000000000000000000000001    
  100000000000000000000000000000000000000000000000000000001    
  100000000000000000000000000000000000000000000000000000001    
  100000000000000000000000000000000000000000000000000000001    
  100000000000000000000000000000000000000000000000000000001    
  100000000000000000000000000000000000000000000000000000001    
  100000000000000000000000000000000000000000000000000000001    
  100000000000000000000000000000000000000000000000000000001    
  100000000000000000000000000000000000000000000000000000001    
  100000000000000000000000000000000000000000000000000000001    
  100000000000000000000000000000000000000000000000000000001   
  100000000000000000000000000000000000000000000000000000001    
  100000000000000000000000000000000000000000000000000000001    
  100000000000000000000000000000000000000000000000000000001    
  100000000000000000000000000000000000000000000000000000001    
  1000000000000000000000000N0000000000000000000000000000001    
  100000000000000000000000000000000000000000000000000000001    
  100000000000000000000000000000000000000000000000000000001   
  100000000000000000000000000000000000000000000000000000001    
  100000000000000000000000000000000000000000000000000000001    
  100000000000000000000000000000000000000000000000000000001    
  100000000000000000000000000000000000000000000000000000001    
  100000000000000000000000000000000000000000000000000000001    
  100000000000000000000000000000000000000000000000000000001    
  100000000000000000000000000000000000000000000000000000001    
  100000000000000000000000000000000000000000000000000000001    
  100000000000000000000000000000000000000000000000000000001    
  100000000000000000000000000000000000000000000000000000001    
  100000000000000000000000000000000000000000000000000000001    
  100000000000000000000000000000000000000000000000000000001    
  100000000000000000000000000000000000000000000000000000001    
  100000000000000000000000000000000000000000000000000000001    
  100000000000000000000000000000000000000000000000000000001    
  100000000000000000000000000000000000000000000000000000001    
  100000000000000000000000000000000010100000100000000010101    
  100000000000000000000000000000000010100000100000000010101  
  100000000000101011101011101011101110100000111111111010101  
  100000000000100000001000100000000010000000000000001000101  
  101111100000111011101110101011111010100000111011111110111  
  101110000000001000101000101010000000100000001000000000001  
  101110000000001011101111111110111010111111101000000000001  
  101110000000000000100000000010001010100000001000000000001  
  101110000000000000100000000010101111111111111000001111101  
  100000000000000000000000000000100000000000001000000000101  
  101110000000001000100000000000111010000000001000001010101  
  101000000000001000000000000000000010000000001000000010001  
  101000111010001000100000000000001010000000001000001010101  
  101000100010001000100000000000001010000000001000001000001  
  101111111010001010111010000000001011100000111000001111101  
  100000111010001010001000000000001000100000000000001000001  
  111111111110001110111010000000001011100000101000001111101  
  100010000010001000001000000000000000000000101000001000101  
  101110111010111010101010000000001010100000101011111011101  
  100000001000000000100010000000001000000000000000000000001  
  111111111111111111111111111111111111111111111111111111111  
